3 3
***
.\*
*.*
3 3
*.*
*\.
***
3 3
***
...
***
50 4
**************************************************
.////////////////////////////////////////////////.
*////////////////////////////////////////////////*
**************************************************
6 8
*.****
*/.//*
*////*
*////*
*/.//*
*////*
*/.//*
***.**
4 5
****
*\/*
*./.
*..*
*.**
4 4
*.**
*.\*
*\\*
**.*
5 5
***.*
*//.*
*\\.*
*...*
***.*
6 6
*.****
*..//*
*\./.*
*/../*
*/....
******
10 10
**********
*\........
*..\....\*
*/.\...\\*
*........*
*....\.\.*
*\\......*
*....\.\.*
.\\....\.*
**********
30 22
*.****************************
*////////////////////////////*
*////////////////////////////*
*////////////////////////////*
*////////////////////////////*
*////////////////////////////*
*////////////////////////////*
*////////////////////////////*
*////////////////////////////*
*////////////////////////////*
*////////////////////////////*
*////////////////////////////*
*////////////////////////////*
*////////////////////////////*
*////////////////////////////*
*////////////////////////////*
*////////////////////////////*
*////////////////////////////*
*////////////////////////////*
*////////////////////////////*
*////////////////////////////*
***************************.**
30 22
*.****************************
*////////////////////////////*
*////////////////////////////*
*////////////////////////////*
*////////////////////////////*
*////////////////////////////*
*////////////////////////////*
*////////////////////////////*
*////////////////////////////*
*////////////////////////////*
*////////////////////////////*
*////////////////////////////*
*////////////////////////////*
*////////////////////////////*
*////////////////////////////*
*////////////////////////////*
*////////////////////////////*
*////////////////////////////*
*////////////////////////////*
*////////////////////////////*
*/////////////////////////.//*
***************************.**
30 22
*.****************************
*////////////////////////////*
*//././//////////////////////*
*////.///////////////////////*
*//////..////////////////////*
*////////.///////////////////*
*//////////..////////////////*
*////////////.///////////////*
*//////////////./////////////*
*////////////////.//////.////*
*///////////////.././////////*
*//////////////////...///////*
*//////////////////////./////*
*////////////////////////.///*
*//////////////////////////./*
*////////////.///////////////*
*///////////////.//./////////*
*///////////////////////.////*
*////////////////////././/./.*
*/////////////////////////.//*
*//////////////////////.//./.*
***************************.**
30 22
*.****************************
*////////////////////////////*
*///////////////////////////.*
*///////////////////////////.*
*///////////////////////////.*
*///////////////////////////.*
*///////////////////////////.*
*///////////////////////////.*
*///////////////////////////.*
*///////////////////////////.*
*///////////////////////////.*
*///////////////////////////.*
*///////////////////////////.*
*///////////////////////////.*
*///////////////////////////.*
*///////////////////////////.*
*///////////////////////////.*
*///////////////////////////.*
*///////////////////////////.*
*///////////////////////////.*
*///////////////////////////.*
****************************.*
50 50
*.************************************************
*////////////////////////////////////////////////*
*/////////////////////////////./././././/////////*
*//////////////////////././..////////////////////*
*///././../././/../././//////////////////////////*
*////////////////////////////////////////////////*
*//////////////////////////////////////./////////*
*/////////////././//////././///////////./////////*
*////////////////////////////////////////////////*
*//////.//////////.//////////./////./////////////*
*////////////////////////////////////////////////*
*////////////////////////////////////////////////*
*////////////////////////////////////////////////*
*////.///.////////.//////.////////.//////////////*
*////////////////////////////////////////////////*
*////////////////////////////////////////////////*
*////////////////////////////////////////////////*
*/////.//////./////./////////////////////////////*
*////////////////////////////////////////////////*
*////////////////////////////////////////////////*
*////////////////////////////////////////////////*
*////////////////////////////////////////////////*
*////////////////////////////////////////////////*
*//////////////./././////////////////////////////*
*////////////////////////////////////////////////*
*////////////////////////////////////////////////*
*/////////////.////////////.////////.////////////*
*////////////////////////////////////////////////*
*////////////////////////////////././/.//////////*
*////////////////////////////////////////////////*
*/////////////////////////////////...////////////*
*////////////////////////////////////////////////*
*////////////////////////////////////////////////*
*////////////////////////////////////////////////*
*///////////////////////////////////.////////////*
*///////////////////////////////////.////////////*
*///////////////////////////////////.////////////*
*///////////////////////////////////.////////////*
*///////////////////////////////////.////////////*
*///////////////////////////////////.///.////////*
*///////////////////////////////////////.////////*
*///////////////////////////////////////.////////*
*///////////////////////////////////////.////////*
*//////////////////////////////////////////./////*
*//////////////////////////////////////////./////*
*//////////////////////////////////////////./////*
*//////////////////////////////////////////.///./*
*//////////////////////////////////////////////./*
*//////////////////////////////////////////////./*
***********************************************.**
-1 -1
