10 10
**********
*/........
*..\....\*
*/.\...\\*
*........*
*....\.\.*
*\\......*
*....\.\.*
.\\....\.*
**********
-1 -1