10 9
**********
*/........
*..\....\*
*/.\...\\*
*........*
*....\.\.*
*\\......*
.....\.\.*
**********
-1 -1