3 3
***
.\*
*.*
3 3
*.*
*\.
***
3 3
***
...
***
6 8
*.****
*/.//*
*////*
*////*
*/.//*
*////*
*/.//*
***.**
4 5
****
*\/*
*./.
*..*
*.**
4 4
*.**
*.\*
*\\*
**.*
5 5
***.*
*//.*
*\\.*
*...*
***.*
6 6
*.****
*..//*
*\./.*
*/../*
*/....
******